################
#X#    @       #
# #            #
# #     #    # #
# #    # #   # #
# #    # #   # #
# #    # #   # #
# #    #C#   # #
# #    # #   # #
# #    #S#   # #
# #    # #   # #
# #    #S#   # #
# #    # #   # #
# ############ #
#              #
################
