################
# #    @       #
# #            #
# #          # #
# #    # #   # #
# #    #C#   # #
# #    # #   # #
# #    #C#   # #
# #    # #   # #
# #    #S#   # #
# #    # #   # #
# #    #S#   # #
# #    # #   # #
# ############ #
#              #
################
